//货币名称
BuyName : "小鱼干"

//管理员全员发钱提示文本
RewText : "管理员奖励了全员"

//管理员全员扣钱提示文本
ConText : "管理员没收了全员"

//不允许购物提示
NotSurT : "只允许生还者购物."
IsDeadT : "死者不允许购物捏."
FreezeT : "您的账户已被管理员冻结, 请联系管理员解冻."
CantBuy : "购物已被管理员禁用."

//商品被冻结-购物失败提示
FreGdst : "你有再多的"
FreGdrd : "也买不到哦~"

//商品购物次数达到上限-购物失败提示
NumLtst : "你有再多的"
NumLtrd : "现在也买不了了."

//货币数量不够-购物失败提示
NEnough : "你需要更多的"

//货币为0-购物失败提示
ZeroBuy : "你看看你的钱包, 空空如也!"

//击杀掠夺提示文本
KIGiveT : "并从其身上掠夺了"

//击杀掠夺货币达到上限时提示
GFullst : "你装"
GFullrd : "的袋子已经满了."

//购物一级菜单目录
SixAmmo : "子弹"
Primawp : "小枪"
Superwp : "大枪"
Medical : "医疗物品"
Missile : "投掷物"
MeleePr : "近战武器"